aaf=Alexei Fedotov <apache@apache.org>
aivanov=Alexey Ivanov <apache@apache.org>
apavlenko=Andrey Pavlenko <apache@apache.org>
apetrenko=Alexey Petrenko <apache@apache.org>
archie=Archie Cobbs <apache@apache.org>
ayza=Alexei Zakharov <apache@apache.org>
bayard=Henri Yandell <apache@apache.org>
chope=Dr Catherine Victoria Hope <apache@apache.org>
chunrong=Chunrong Lai <apache@apache.org>
clraychen=Lei Chen <apache@apache.org>
dlydick=Daniel Lydick <apache@apache.org>
dtanzer=David Tanzer <apache@apache.org>
egor=Egor Pasko <apache@apache.org>
gbrown=Gregory K. Brown <apache@apache.org>
gchanan=Gregory Chanan <apache@apache.org>
geirm=Geir Magnusson Jr <apache@apache.org>
ggregory=Gary D. Gregory <apache@apache.org>
gharley=George Harley <apache@apache.org>
gkossakowski=Grzegorz Kossakowski <apache@apache.org>
gmonroe=C. Gregory Monroe <apache@apache.org>
greddin=Gregory D. Reddin <apache@apache.org>
gregor=Gregor Rothfuss <apache@apache.org>
gregw=Gregory John Wilkins <apache@apache.org>
grisha=Gregory Trubetskoy <apache@apache.org>
gshimansky=Gregory Shimansky <apache@apache.org>
gshimansky=Gregory Shimansky <apache@apache.org>
hindessm=Mark Hindess <apache@apache.org>
iberezhn=Ilya Berezhniuk <apache@apache.org>
ivavladimir=Vladimir Ivanov <apache@apache.org>
jessewilson=Jesse Wilson <apache@apache.org>
leoli=Li Yi Lei <apache@apache.org>
liangyx=Yanxuan Liang <apache@apache.org>
littlee=Li Jing Qin <apache@apache.org>
lvjing=Jing Lv <apache@apache.org>
mcfirst=Pavel Pervov <apache@apache.org>
mfursov=Mikhail Fursov <apache@apache.org>
mloenko=Mikhail Loenko <apache@apache.org>
mmarkov=Mikhail Markov <apache@apache.org>
mschaaf=Marc Schaaf <apache@apache.org>
nadinem=Nadezhda Morozova <apache@apache.org>
ndbeyer=Nathan Beyer <apache@apache.org>
odeakin=Oliver Deakin <apache@apache.org>
oschaaf=Otto van der Schaaf <apache@apache.org>
pyang=Yang Pu <apache@apache.org>
qiuxx=Qiu Xia <apache@apache.org>
regisxu=Xu Rui Zhi <apache@apache.org>
shade=Aleksey Shipilev <apache@apache.org>
sjanuary=Sian January <apache@apache.org>
smishura=Stepan Mishura <apache@apache.org>
stefanoinve=Stefano Invernizzi <apache@apache.org>
stefano=Stefano Mazzocchi <apache@apache.org>
tellison=Tim Ellison <apache@apache.org>
tonywu=Wu Yue Hao <apache@apache.org>
varlax=Alexey Varlamov <apache@apache.org>
vmz=Vasily Zakharov <apache@apache.org>
wjwashburn=Weldon Washburn <apache@apache.org>
xli=Xiao-Feng Li <apache@apache.org>
yanglang=Lang Yang <apache@apache.org>
yegor=Yegor Kozlov <apache@apache.org>
zhanghuangzhu=Zhang Huang Zhu <apache@apache.org>
zhoukevin=Zhou Kai <apache@apache.org>
